R 1300 700
NO texture/eagle.xpm
SO texture/eagle.xpm
WE texture/eagle.xpm
EA texture/eagle.xpm
S texture/eagle.xpm

C 0,0,0
F 0,0,0
     1111111111                11111111111111111111111111111111111111
     1111011111                10111111111101111111111111111111
     1000000001                10000000000000000000000000000001
     1000000001                100000000000000000111111111111111111111
     1000000001111111111111111110000000000001000001000000000000000001
     1000000000000000000000000000000000000001000001000000000000000001
     1000000001111111111111111110000000000001000001000000000000000001
     1000000001 10000000000000000000000002000000000000000000000000001
     1000000001  1000000000000000000000000000000000000000000000000001
     1111111111   100000000000000000000000000001111111011111111111111
                  111111111111110000000000000001     101
                               10000000000000001     101
                               10000000000000001     101
                               1000000000000000111111101
                               1000000000N0000000000000111111
                               111111111111111111111111111111
