R 1200 800 
NO texture/eagle.xpm
SO texture/eagle.xpm
WE texture/wood.xpm
EA texture/nazi.xpm
S texture/barrel.xpm

C 0, 255,255
F 15,100,30

1111111111111111111111111111
1000000000000200000000000001
1000000000000000000000000001
1000000000000000000000000001
1000000000000000000000000001
1000000000000000000000000001
1000000000000000000000000001
1000000000000000000000000001
1000000000000000000000000001
1000000000000000000000000001
1000000000000000000000000001
1000000000000000000000000001
1000000000000000000000000001
1000000000000000000000000001
1000000000000000000000000001
1000000000000000000000000001
1000000000000000000000000001
1000000000000000000000000001
1000000000000000000000000001
1000000000000000000000000001
1000000000000000000000000001
1000000000000000000000000001
1000000000000000000000000001
1000000000000000000000000001
1000000000000N00000000000001
 111111111111111111111111111
