R 700 700
NO texture/colorstone.xpm
SO texture/eagle.xpm
WE texture/wood.xpm
EA texture/nazi.xpm
S texture/barrel.xpm

C 0,0,0
F 0,0,0

         111111111111111111111111
        1000000000000000000000001
        1000000000000000000000001
        1000000000000000000000001
111111111000000000000000000000001   
10000000000000000000000000001111
10000000000000000000000000001       
10000000000000000000000000000
1000001000000E000000002000001
100001 1000000000000000000001
10000010000000000000000000001111
100000000000000000000000000000001
100000000000000000000000000011111
10000000000000000000000000001
10000000000000000000000000001
10000000000000000000000000001
10000000000000000000000000001111
100000000000000000000000000000001
100000000000000000000000000011111
10000000000000000000000000001
10000000000000000000000000001
10000000000000000000000000001
10000000000000000000000000001
10000000000000000000000000001
10000000000000000000000000001
1000000000000000000000000000111
10000001110000011100000000001
11111111 1111111 111111111111
