R 1200 800 
NO texture/eagle.xpm
SO texture/eagle.xpm
WE texture/wood.xpm
EA texture/nazi.xpm
S texture/barrel.xpm

C 0,0,0
F 15,100,30

         11111111111111111111111  
        1000000000000000000000001
        1000000000002000000000001
        1000000000001000000000001
 11111111000000000000000001000001   
100000000000000000000000001000111
 11111111000000000000000001000001   
 11111111000001000000000000000001   
 11111111000010100000000000000001   
 11111111000001000000000000000001   
 11111111000000000000000000000001   
 111111110000000000000111000000001   
 1111111100000000000001  100000111   
 111111110000000000000111000001   
 1111111100000000000000000000001   
10000000000000000000000000000111
10000000000000000000000000000111
10000000000000000000000000000111
10000000000000000000000000000111
100000000000000000N0000000000111
10000000000000000000000000000111
10000000000000000000000000000111
10000000000000000000000000000111
10000000000000000000000000000111
10000010000000100000000000001
 11111 1111111 1111111111111
