R 1000 700
NO texture/eagle.xpm
SO texture/eagle.xpm
WE texture/wood.xpm
EA texture/nazi.xpm
S texture/barrel.xpm

C 0, 255,255
F 15,100,30

1111111111111111111111111 1111111111111
12222222222222222222222222222222222221
12000000000000000000000000000000000021
12000000000000000000000000000000000021
12000000000000000000000000000000000021
12000000000000000000000000000000000021
1200000E000000000000000000000000000021
12000000000000000000000000000000000021
12000000000000000000000000000000000021
12000000000000000000000000000000000021
12000000000000000000000000000000000021
1200000000000000000000000000000000021
1200000000000000000000000000000000021
1200000000000000000000000000000000021
1200000000000000000000000000000000021
1200000000000000000000000000000000021
1200000000000000000000000000000000021
1200000000000000000000000000000000021
1200000000000000000000000000000000021
1200000000000000000000000000000000021
1200000000000000000000000000000000021
1200000000000000000000000000000000021
1200000000000000000000000000000000021
1200000000000000000000000000000000021
1222222222222222222222222222222222221
 111111111111111111111111111111111111
