R 1000 700
NO texture/eagle.xpm
SO texture/eagle.xpm
WE texture/wood.xpm
EA texture/nazi.xpm
S texture/barrel.xpm

C 0, 255,255
F 15,100,30

111111111111111111111111111111111111111
12000000000000020000000000000000000001
10000000000000212000000000000000000001
10000000000002111200000000000000000001
100000000000211 1120000000000000000001
10000000000211   112000000000000000001
100000000000211 1120000000000000000001
10000000000002111200000000000000000001
10000000000000212000000000000000000001
10000000000000020000000000000000000001
10000000000000000000000000000000000001
1000000000000000000000000000000000001
1000000000000002000000000000000000001
1000000000000021200000000000000000001
1000000000000211120000000000000000001
100000000000211 112000000000000000001
10000000000211   11200000000000000021
100000000000211 112000000000000000021
1000000000000211120000000000000000021
1000000000000021200000000000000000021
1000000000000002000000000000000000021
1000000000000000000000000000000000021
100E0000000000000000000000012000000021
1000000000000000000000000000000000021
1000000000000000000000000000000000021
 111111111111111111111111111111111111
