R 700 500
NO texture/eagle.xpm
SO texture/eagle.xpm
WE texture/wood.xpm
EA texture/nazi.xpm
S texture/barrel.xpm

C 0, 255,255
F 15,100,30

1111111111111111111111111111
1000000000000000000000000001
1000020002000020000200002001
1000000000000000000000000001
1000000000000000000000000001
10000000000000E0000000000001
1000000000000000000000000001
1111111111111101111111111111
1111111111111101111111111111
1111111111111101111111111111
1111111111111101111111111111
1111111111111101111111111111
1111111111111101111111111111
1111111111111101111111111111
1111111111111101111111111111
1111111111111101111111111111
1111111111111101111111111111
1111111111111101111111111111
1111111111111101111111111111
1111111111111101111111111111
1111111111111101111111111111
1111111111111111111111111111
1111111111111111111111111111
1111111111111111111111111111
1111111111111111111111111111
 111111111111111111111111111
