R 1200 800 
NO texture/eagle.xpm
SO texture/eagle.xpm
WE texture/wood.xpm
EA texture/nazi.xpm
S texture/barrel.xpm

C 255, 255,200
F 0,0,0
         11111111111111111111111  
        1000000000000000000000001
        1000022222222222222000001
        1000000000000000000000001
 11111111000000000000000000000001   
10000000000000000000N00000000111
10000010000000100000000000001
 11111 1111111 1111111111111
