R 1200 800 
NO texture/eagle.xpm
SO texture/eagle.xpm
WE texture/wood.xpm
EA texture/nazi.xpm
S texture/barrel.xpm

C 255,256,200
F 0,0,0

         11111111111111111111111  
        1000000000000000000000001
        1000000000000000000000001
        1000000000000000000000001
 11111111000000000000000000000001   
10000000000000000000000000000111
10000000000000000000000000001       
10000000000000000000000000001
10000000000000000000002000001
11000000000000000000000000001
11000000000000000000000000001111
11000000000000000000000000000001
11000000000000000000000000001111 
110000000W0000000000000000001
11000000000000000000000000001
11000000000000000000000000001
11000000000000000000000000001111
110000000000000000000000000000001
11000000000000000000000000001111 
11000000000000000000000000001
11000000000000000000000000001
11000000000000000000000000001
11000000000000000000000000001
11000000000000000000000000001
10000000000000000000000000001
1000000000000000000000000000011
10000000100000001000000000001
 11111 1111111 11111111111 
